111111111111111
1000000P000C001
101111111C00001
100C1E0000000C1
111111111111111
