111111111111111111111111111111111111111
10E000100000000000000000000000000000001
100000110010000010100100000001010000001
111101101010101000100100000001010000001
100001000C00CP000000000000000000C000001
1001110000000000000000000000M0000000001
100000010010000010100100000001010000001
100000001010101000100100000001010000001
100000000C00C0000000000000000000C000001
111111111111111111111111111111111111111
