111111111111111
10000P00000C001
101111111C00001
100C10000E00001
111111111111111
