111111111111111
10C0000000000P1
10C00E00000P0C1
110001110100001
111111111111111
