111111111111111
10C000000000001
10C00E0000KP0C1
110001110100001
111111111111111
