11111111111111111111111111111111111111
10000000000000000000M0000000000C000001
1000000000P000000000000000000000000001
1000000000000000000000000E000000000001
10000000000000000000000000000000000001
10000000000001111111000000000C00000001
100000000000000C0000000000000000000001
10001000000000000000000000000000000001
11111111111111111111111111111111111111
